################################
#  A       ###########     #####
#          ##                  #
#  ##      ## ###   ##         #
#  ####    ##  ##      ######  #
#####     ######   ##  ####    #
###       #####      ### ##  ###
#       #########    ##  ##  ###
#                        ##    #
###       ###  ###  ######     #
####################### B      #
################################
